BC_TEVs	TEVs
CGATGT	ENLYFQS
TGACCA	ENLYFQA
ACAGTG	ENLYFQC
GCCAAT	ENLYFQD
CAGATC	ENLYFQE
CTTGTA	ENLYFQF
ATCACG	ENLYFQG
TTAGGC	ENLYFQH
ACTTGA	ENLYFQI
GATCAG	ENLYFQK
TAGCTT	ENLYFQL
GGCTAC	ENLYFQM
AGTCAA	ENLYFQN
AGTTCC	ENLYFQP
ATGTCA	ENLYFQQ
CCGTCC	ENLYFQR
GTAGAG	ENLYFQT
GTCCGC	ENLYFQW
GTGAAA	ENLYFQV
GTGGCC	ENLYFQY
